NO ./textures/minecraft1.xpm
SO ./textures/minecraft1.xpm
WE ./textures/minecraft1.xpm
EA ./textures/minecraft1.xpm

F 255,255,255
C 255,255,255

111111111111
1011N1N1111111
NSW110111111111
N111011111111
000000000000
