NO ./textures/minecraft1.xpm
SO ./textures/minecraft2.xpm
WE ./textures/minecraft3.xpm
EA ./textures/minecraft4.xpm

F               0,255,255
C                          255,255,255


111111111111111111111111
100000000000000000000001
101111111111011111111101
100000000001000000000001
101111111101011111110101
100000000001000000010001
101111111101111111010101
100000000000000001000001
101111111111111101111101
100000000000000001000001
101111111111011111111101
100000000001000000000001
101111111101111111110101
100000000001000000000001
1000000000000N0000000001
111111111111111111111111
