NO ../textures/minecraft1.xpm
SO ../textures/minecraft2.xpm
EA ../textures/minecraft3.xpm
WE ../textures/minecraft4.xpm

C 245,245,245
F 245,245,245


1111111111111111111111111
1000000000000000000000001
1001111111100000111111001
1001000000100000100001001
10010000001000W0100001001
1001000000100000100001001
1001111111111111111111001
1000000000000000000000001
1111111111111111111111111
