NO ./Makefile
SO ./textures/minecraft1.xpm
WE ./textures/minecraft1.xpm
EA ./textures/minecraft1.xpm

F 255,255,255
C 255,255,255

        1111111111111111111111111
        1000000000110000000000001
        10110000011100000100N0001
        1001000000000000110000001
111111111011000001110000010000001
100000000011000001110111111111111
11110111111111011100000010001
11110111111111011101010010001
1100000011010101110000010001
10000000000000001100000010001
10000000000000001101010010001
1100000111010101111101111010111
11110111 1110101 10111101001
11111111 1111111 1111111111
