NO ./path_to_the_north_texture
SO ./path_to_the_south_texture
WE ./path_to_the_west_texture
EA ./path_to_the_east_texture

F 220,100,0
C 225,30,0

1111111111111111111111111
1000000000110000000000001
1011000001110000000000001
1001000000000000000000001
1111111110110000011100001
1000000000110000011101111
1111011111111101110000001
1111011111111101110101011
1100000011010101110000001
1000000000000000110000001
1000000000000000110101011
1100000111010101111101111
1111011111110101111101111
1111111111110111111111111
111111111111N111111111111
