NO ./textures/minecraft1.xpm
SO ./textures/minecraft1.xpm
WE ./textures/minecraft1.xpm
EA ./textures/minecraft1.xpm

F 255,255,255
C 255,255,255

1111111111111
10N0100000001
1111111111111
