NO ./textures/minecraft1.xpm
SO ./textures/minecraft1.xpm
WE ./textures/minecraft1.xpm
EA ./textures/minecraft1.xpm

F               0,0,255
C                          255,0,0


111111111111111111111111111111111111111111111
100000000000000000000000000000000000000000001
100000000000000000000000000000000000000000001
100000000000000000000000000000000000000000001
100000000000000000000000000000000000000000001
100000000000000000000000000000000000000000001
100000000000000000000000000000000000000000001
100000000000000000000000000000000000000000001
100000000000000000000000000000000000000000001
100000000000000000000000000000000000000000001
100000000000000000000000000000000000000000001
100000000000000000000000000000000000000000001
1N0000000000000000000000000000000000000000001
111111111111111111111111111111111111111111111
